町丁別	世帯数	総数	男	女	男per女100人	人口密度	小計
南台総数	11500	20217	10140	10077	100.63	24959	1
南台一丁目	776	1290	646	644	100.31	16125	0
南台二丁目	3110	5346	2643	2703	97.78	33413	0
南台三丁目	2875	5294	2628	2666	98.57	25210	0
南台四丁目	2310	4025	2027	1998	101.45	21184	0
南台五丁目	2429	4262	2196	2066	106.29	25071	0
弥生町総数	13574	22562	11251	11311	99.47	22339	1
弥生町一丁目	4017	6408	3354	3054	109.82	30514	0
弥生町二丁目	3138	5005	2463	2542	96.89	27806	0
弥生町三丁目	1792	2948	1485	1463	101.5	26800	0
弥生町四丁目	1863	3270	1571	1699	92.47	21800	0
弥生町五丁目	1813	3220	1577	1643	95.98	11926	0
弥生町六丁目	951	1711	801	910	88.02	19011	0
本町総数	18638	29410	14563	14847	98.09	27745	1
本町一丁目	2320	3735	1857	1878	98.88	31125	0
本町二丁目	2912	4599	2370	2229	106.33	20905	0
本町三丁目	3596	5567	2791	2776	100.54	32747	0
本町四丁目	4440	6953	3383	3570	94.76	31605	0
本町五丁目	2398	3750	1821	1929	94.4	23438	0
本町六丁目	2972	4806	2341	2465	94.97	28271	0
中央総数	18460	29189	14857	14332	103.66	25163	1
中央一丁目	3618	5672	2861	2811	101.78	24661	0
中央二丁目	4037	6397	3292	3105	106.02	21323	0
中央三丁目	3456	5370	2772	2598	106.7	26850	0
中央四丁目	4137	6516	3321	3195	103.94	28330	0
中央五丁目	3212	5234	2611	2623	99.54	26170	0
東中野総数	14688	23275	11565	11710	98.76	24500	1
東中野一丁目	4237	6586	3312	3274	101.16	27442	0
東中野二丁目	2679	4455	2132	2323	91.78	20250	0
東中野三丁目	2045	3203	1586	1617	98.08	20019	0
東中野四丁目	2757	4088	2020	2068	97.68	25550	0
東中野五丁目	2970	4943	2515	2428	103.58	29076	0
中野総数	17113	27022	14146	12876	109.86	18382	1
中野一丁目	3555	5915	3151	2764	114	23660	0
中野二丁目	1517	2593	1300	1293	100.54	12348	0
中野三丁目	3769	5984	3161	2823	111.97	24933	0
中野四丁目	1743	2266	1171	1095	106.94	7081	0
中野五丁目	4361	6562	3475	3087	112.57	21873	0
中野六丁目	2168	3702	1888	1814	104.08	24680	0
上高田総数	13014	20809	10765	10044	107.18	20603	1
上高田一丁目	3386	5556	2838	2718	104.42	20578	0
上高田二丁目	3372	5084	2723	2361	115.33	25420	0
上高田三丁目	2108	3314	1732	1582	109.48	25492	0
上高田四丁目	2262	3770	1899	1871	101.5	19842	0
上高田五丁目	1886	3085	1573	1512	104.03	14023	0
新井総数	11256	18225	9432	8793	107.27	22500	1
新井一丁目	2896	4306	2251	2055	109.54	28707	0
新井二丁目	3310	5359	2803	2556	109.66	26795	0
新井三丁目	1623	2971	1584	1387	114.2	12379	0
新井四丁目	1822	3113	1529	1584	96.53	25942	0
新井五丁目	1605	2476	1265	1211	104.46	24760	0
沼袋総数	8314	13506	6876	6630	103.71	20158	1
沼袋一丁目	2145	3418	1760	1658	106.15	20106	0
沼袋二丁目	2113	3426	1734	1692	102.48	19033	0
沼袋三丁目	2040	3203	1664	1539	108.12	20019	0
沼袋四丁目	2016	3459	1718	1741	98.68	21619	0
松が丘総数	3774	6410	3300	3110	106.11	16868	1
松が丘一丁目	1978	3278	1683	1595	105.52	15610	0
松が丘二丁目	1796	3132	1617	1515	106.73	18424	0
江原町総数	4910	8952	4418	4534	97.44	17215	1
江原町一丁目	1673	3233	1544	1689	91.42	15395	0
江原町二丁目	1813	3346	1665	1681	99.05	18589	0
江原町三丁目	1424	2373	1209	1164	103.87	18254	0
江古田総数	6158	12038	5872	6166	95.23	15839	1
江古田一丁目	1636	3249	1644	1605	102.43	17100	0
江古田二丁目	1371	2580	1235	1345	91.82	21500	0
江古田三丁目	627	1673	708	965	73.37	7274	0
江古田四丁目	2524	4536	2285	2251	101.51	20618	0
丸山総数	2763	5010	2480	2530	98.02	17893	1
丸山一丁目	1118	2043	1000	1043	95.88	14593	0
丸山二丁目	1645	2967	1480	1487	99.53	21193	0
野方総数	12821	21095	10710	10385	103.13	22929	1
野方一丁目	3009	4903	2553	2350	108.64	25805	0
野方二丁目	2819	4938	2568	2370	108.35	24690	0
野方三丁目	1586	2657	1374	1283	107.09	22142	0
野方四丁目	2011	3263	1621	1642	98.72	21753	0
野方五丁目	1305	2128	1030	1098	93.81	19345	0
野方六丁目	2091	3206	1564	1642	95.25	21373	0
大和町総数	9566	15630	8161	7469	109.26	22014	1
大和町一丁目	3335	5095	2661	2434	109.33	25475	0
大和町二丁目	1984	3226	1715	1511	113.5	21507	0
大和町三丁目	2250	3542	1844	1698	108.6	23613	0
大和町四丁目	1997	3767	1941	1826	106.3	17938	0
若宮総数	7646	12868	6501	6367	102.1	19206	1
若宮一丁目	2501	4081	2104	1977	106.42	21479	0
若宮二丁目	2246	4031	2062	1969	104.72	19195	0
若宮三丁目	2899	4756	2335	2421	96.45	17615	0
白鷺総数	5911	11371	5401	5970	90.47	18340	1
白鷺一丁目	2091	4083	1903	2180	87.29	18559	0
白鷺二丁目	2198	4164	1995	2169	91.98	18927	0
白鷺三丁目	1622	3124	1503	1621	92.72	17356	0
鷺宮総数	9467	16782	8301	8481	97.88	19290	1
鷺宮一丁目	1684	2679	1345	1334	100.82	20608	0
鷺宮二丁目	876	1486	723	763	94.76	16511	0
鷺宮三丁目	2135	3579	1801	1778	101.29	19883	0
鷺宮四丁目	1814	3085	1521	1564	97.25	15425	0
鷺宮五丁目	1200	2416	1206	1210	99.67	21964	0
鷺宮六丁目	1758	3537	1705	1832	93.07	22106	0
上鷺宮総数	6559	13844	6643	7201	92.25	15213	1
上鷺宮一丁目	1149	2284	1128	1156	97.58	16314	0
上鷺宮二丁目	1328	2783	1365	1418	96.26	13252	0
上鷺宮三丁目	1152	2538	1181	1357	87.03	18129	0
上鷺宮四丁目	1256	2485	1162	1323	87.83	17750	0
上鷺宮五丁目	1674	3754	1807	1947	92.81	13407	0
